%%%%%%%%%%%%%%%%%%%%%%%%%%%%%%%%%%%%%
%                                  S%
%            %                      %
%            %                      %
%            %%%%%%%%%%%%%%%%%%%%%  %
%            %                      %
%            %    %%%%%%%%%%%%%%%%%%%
%            %                      %
%            %%%%%%%%%%%%%%%%%%%%   %
%            %                      %
%            %      %               %
%            %% %%%%%%%%%%%%%%%%%%%%%
%            %                      %
%            %                      %
%%%%%%%%%%%% %      %%%%%%%%%%%%%%%%%
%            %       %              %
%            %         %%   %       %
%            %%%%%%%%%%%%%%%%       %
%                         %         %
%                         %         %
%                         %%%%%%%%%%%
%                                   %
%%%%%%%%%%%%%%%%%%%%%%%%%%%%%%%%%%%G%